1111111111111111111111111111111111111111
1000C011000000000000000001C0000000000001
1011101100010000110100000111100011100001
100100110001000111C111000100000011100001
1001001100010001111111000000000000000001
100110000C000000000100000100000111111001
10010000111110000010000000000001000C0001
1000000000000000001011111000111100111001
1011001100000001100000000000000100100111
1001001P00000001110000000000000100100001
10C0001100011000000000000111110000000001
1111111111111001111001111111000000000001
1000000000100001100000000000011000000001
10010010001000111001110000010C1100000001
1001001110100010000000000001000000001101
100100000C100010110000100001000111111101
10011111111000100000001000000001100C11C1
1000000000000011100001110001100110111101
1000011100000000000100000001110000001101
100100C100010000001100000000000000000001
100111110001001111111111111111000000E001
1000000000010011000000000000000000001111
1000000C00010011011111111111110001000001
1000011110000011010000C00000011101100101
1110000100000011C11111111110011101100101
1111000111000011000000000000010001001C01
10C0000100000011111111110111110000001001
1111111111111111111111111111111111111111
