1111111111111111111111111111
111P000000100000000001C000B1
1000010001100001100001001001
100001C011000001100000000001
1000010000011111100000100001
1000010000000001100010111101
1C00000110001C00000000111101
10000100000011111100000000C1
1000010001000000010011111101
1000110000000100010000000001
1101111110000100011110000001
110C000010000001000000000001
1000000010011100011111110001
1001110010000101000000000CE1
10010C0010000101111110000001
110011111000M001C10000000001
1000000000000001010000110001
1011100000101000000000110001
100C0000001C0000100000000C01
1111111111111111111111111111