1111111111111111111111111
10C00M000000B00000000C001
1000000001000000001001101
1111100001101110011000011
111C000001000000010000111
100C100001CC0000000111C11
10111001000000P0001000011
1000000100000001111011111
1000111110000000000000001
1000000000100011000010C01
1010011000100001000011101
1C000110010000010C00000E1
1111111111111111111111111
