111111111111111
100000E00000001
100000000C00001
111110111111101
111C0000010C001
100000000100P01
111111111111111