11111111111111111111111111111111111111111111111111111111111
10EP000000000000000000000000000000CCCCCCCCCCCCCCCCCCC000111
10000000000000CCCCCCCCCCCCCCCCC0000000111000000000000000001
1000CCCC000000000000010000CCCCCCCCCCC0111000000000000000001
1000CCCC00000000000000000000000000000000000000000C000000001
1000CCCC000011000000000000000000000000000000000000000000001
1C000000000011000000000000000100000000000001000000000000C01
10000000000000000000000000000000000000000000000000000000001
1000000000000000000000000C0000000000000000CCCCCCCCC00000001
10000001000000000000000000000000C000000001CCCCCCCCC00000001
10000CCCCCCCCCC00010000000000000000000000000000000000100001
1000000CCCCCC0000000000000000000000000000000000000000000001
1000000CCCCCC00C0CCCCCCCCC001100000000000C00000001000000001
10000000000000000000000000000000000000000000000000000000001
100001000000000CCCC0001110000000000000000000000000000000001
100000000000000CCCCC001110000000000000010000000000000000001
100000000000100CCCCC000000000000000000000000000000010000001
100000000000000CCCCCCCCCCCCCCCCCCC0000000000000000000000001
11100000000000000000000000000000000010000000000000000000001
11100000000000011000000000000000000000000000000000000000001
100000000000000000000000000000000000000000000CCCCCC00110001
100000010000000000000000000000000001000000000CCCCCC00000001
100000000000000000000000000000000000000000010CCCCCC10000001
10000000C0000010000000000100000C0000000000000CCCCCC0C000001
10000000000000000000100000000000000000000000000000000000001
11111111111111111111111111111111111111111111111111111111111