11111111111111111111111111111111111111111111111111111111111
10EP0000000000000000000000000000000000000000000000000000111
10000000000000C00000000000000000000000111000000000000000001
10000000000000000000010000000000000000111000000000000000001
1000000000000000000000000000000000000000000000000C000000001
10000000000011000000000000000000000000000000000000000000001
1C000000000011000000000000000100000000000001000000000000C01
10000000000000000000000000000000000000000000000000000000001
1000000000000000000000000C000000000000000000000000000000001
10000001000000000000000000000000C00000000100000000000000001
10000000000000000010000000000000000000000000000000000100001
10000000000000000000000000000000000000000000000000000000001
100000000000000C00000000000011000M0000000C00000001000000001
10000000000000000000000000000000000000000000000000000000001
10000100000000000000001110000000000000000000000000000000001
10000000000000000000001110000000000000010000000000000000001
10000000000010000000000000000000000000000000000000010000001
10000000000000000000000000000000000000000000000000000000001
11100000000000000000000000000000000010000000000000000000001
11100000000000011000000000000000000000000000000000000000001
100000000000000000000000000000000000000000000C0000000110001
10000001000000000000000000000000000100000000000000000000001
10000000000000000000000000000000000000000001000000010000001
10000000C0000010000000000100000C00000000000000000000B000001
10000000000000000000100000000000000000000000000000000000001
11111111111111111111111111111111111111111111111111111111111